PhineasPF: Phineas, Mr. Finn
LordChilternPF: Oswald, Chiltern
VioletPF: Violet, Miss Effingham
MadameMaxPF: Madame Max, Goesler
LadyLauraPF: Laura
RobertKennedyPF: Mr. Kennedy, Robert
LadyGlencoraPF: Glencora
PlantPalliserOmPF: Plantagenet, Mr. Palliser
MrTurnbullPF: Turnbull
MrBonteenPF: Mr. Bonteen, Bonteen
MrsBonteenPF: Mrs. Bonteen
EarlBrentfordPF: Brentford, the Earl
JacobBuncePF: Mr. Bunce, Jacob
MrsBuncePF: Mrs. Bunce
LordCantripPF: Cantrip
LaurenceFitzgibPF: Laurence, Fitzgibbon
AspasiaFitzgibPF: Miss Fitzgibbon, Aspasia
BarringtonErlePF: Barrington, Mr. Erle
MrGreshamPF: Mr. Gresham
MrsGreshamPF: Mrs. Gresham
MildmayPF: Mildmay
JoshMonkPF: Monk
OldOmniumPF: Omnium, the Duke
DukeStBungayPF: the Duke of St. Bungay
MrAppledomPF: Appledom
LadyBaldockPF: Baldock
LadyCantripPF: Lady Cantrip
MrClarksonPF: Clarkson
MrDaubenyPF: Daubeny
LordDeTerrierPF: Terrier
LordFawnPF: Fawn
DrMalFinnPF: Dr. Finn
LordFitzhowardPF: Fitz-Howard
DowagerHartletopPF: Hartletop
MaryFloodPF: Mary
MrsFloodJonesPF: Mrs. Flood Jones
MrLowPF: Mr. Low
MrsLowPF: Mrs. Low
GeorgeMorrisPF: Mr. Morris, George Morris
MrRatlerPF: Ratler
ThomasRobyPF: Roby
EarlTullaPF: the Earl of Tulla, Tulla
AugustaBorehamPF: Augusta
MrWesternPF: Mr. Western
LeggeWilsonPF: Legge
