CrosbieSH: Crosbie, Adolphus
BellDaleSH: Bell
LilyDaleSH: Lily, Lilian
MaryDaleSH: Mrs. Dale, Mary Dale, MaryDaleS
EarlDeGuestSH: Lord De Guest, Theodore
JohnnyEamesSH: Johnny, Mr. Eames, John Eames, Mr. John
SirBuffleSH: Sir Raffle, Raffle Buffle, old Buffle
JoeCradellSH: Cradell
DrCroftsSH: Crofts, the doctor
LadyCrosbieSH: Alexandrina
BernardDaleSH: Bernard
ChristopherDaleSH: the squire, Christopher, Mr. Dale
LadyDeGuestSH: Lady Julia
MortimerGazebeeSH: Mortimer, Mr. Gazebee
GriseldaGrantlySH: Griselda
MrsGrantlySH: Mrs. Grantly 
AmeliaRoperSH: Amelia, Miss Roper
MrsRoperSH: Mrs. Roper
RevArabinSH: Dr. Arabin
MarqAuldReekieSH: Auldreekie, the marquis
RevBoyceSH: Mr. Boyce
MrsBoyceSH: Mrs. Boyce
MrButterwellSH: Butterwell
Lady ClandidlemSH: Lady Clandidlem
MrsCrumpSH: Mrs. Crump
ColDaleSH: the colonel, Colonel Dale
CountessDeCourcySH: Countess De Courcy, the countess, Rosina De Courcy
EarlDeCourcySH: Lord De Courcy
LadyDeCourcySH: Lady Rosina, Rosina
GeorgeDeCourcySH: George
JohnDecourcySH: John De Courcy, Honourable John
MrsGDeCourcySH: Mrs. George
MontgomDobbsSH: Montgomerie
MaryEamesSH: Mary Eames
MrsEamesSH: Mrs. Eames
MajorFiascoSH: Fiasco, the major
MrFisherSH: Fisher
BurgoFitzgeraldSH: Burgo
LordFitzHowardSH: Fitzhoward
MrFothergillSH: Fothergill
AugustaGreshamSH: Miss Gresham
SeptimusHardingSH: Mr. Harding
DowagerHartletopSH: Marchioness of Hartletop, Lady Hartletop
GustavusHartletopSH: Gustavus
MrsHearnSH: Mrs. Hearn
HopkinsSH: Hopkins
MariaLupexSH: Maria, Mrs. Lupex
OrsonLupexSH: Orson, Mr. Lupex
GlencoraPalliserSH: Glencora
PlantagenetPalliserSH: Plantagenet, Mr. Palliser
MrOptimistSH: Optimist
LordPorlockSH: Porlock
FowlerPrattSH: Fowler, Mr. Pratt
SallySpruceSH: Spruce
