SophroniaOMF: Sophronia Akershem, Sophronia, Mrs Alfred Lammle, Mrs Lammle
MrBoffinOMF: Mr Boffin, Nicodemus Boffin, Noddy, the Golden Dustman
MrsBoffinOMF: Mrs Boffin
JennyOMF: Fanny Cleaver, Jenny Wren, Jenny, Miss Wren, dressmaker
MrDollsOMF: Mr Dolls, bad child
FledgebyOMF: Fledgeby
JohnHarmonOMF: John Harmon, Mr John Harmon, Mr Harmon, Julius Handford, Mr Handford, John Rokesmith, Mr Rokesmith, John, Secretary
BradleyOMF: Bradley Headstone, Mr Headstone, Bradley, schoolmaster
CharleyHexamOMF: Charley Hexam, Mr Hexam, Charley
GafferHexamOMF: Jesse Hexam, Gaffer Hexam, Gaffer
LizzieHexamOMF: Lizzie Hexam, Miss Hexam, Lizzie, Mrs Eugene Wrayburn, Mrs Eugene
BettyHigdenOMF: Mrs Higden, Betty
MrInspectorOMF: Mr Inspector
JohnnyOMF: Johnny
AlfredLammleOMF: Mr Alfred Lammle, Alfred Lammle, Mr Lammle, Alfred
LightwoodOMF: Mortimer Lightwood, Mr Lightwood, Mortimer
MaryAnneOMF: Mary Anne
RevFrankMilveyOMF: Reverend Frank Milvey, Reverend Frank, Mr Milvey
MissPeecherOMF: Miss Peecher, Emma Peecher
GeorgianaPodOMF: Miss Podsnap, Georgiana Podsnap, Georgiana
MrPodsnapOMF: John Podsnap, Mr Podsnap
MrsPodsnapOMF: Mrs Podsnap
AbbeyPottersonOMF: Miss Abbey Potterson, Miss Potterson, Miss Abbey, Abbey
MrRiahOMF: Riah, Jew
PleasantOMF: Pleasant Riderhood, Miss Riderhood, Miss Pleasant
RRiderhoodOMF: Rogue Riderhood, Riderhood, Roger, Rogue
GeorgeSampsonOMF: Sampson
SloppyOMF: Sloppy
TwemlowOMF: Twemlow
MrVeneering: Hamilton Veneering, Hamilton, Mr Veneering, Veneering
MrsVeneering: Anastasia Veneering, Anastasia, Mrs Veneering
MrVenusOMF: Venus
WeggOMF: Silas Wegg, Mr Wegg, Silas
BellaOMF: Bella Wilfer, Miss Wilfer, Bella, Mrs John Harmon, Mrs John Rokesmith, Mrs Rokesmith
LaviniaOMF: Lavinia Wilfer, Lavinia, Lavvy
MrsWilferOMF: Mrs Wilfer
MrWilferOMF: Reginald, R. Wilfer, Mr Wilfer, Wilfer, Pa, R.W.
WrayburnOMF: Eugene Wrayburn, Eugene, Wrayburn, Governor
